Two years. That's how long you've been planning this escape. Every detail mapped out, every contingency considered. Tonight's the night. You will break this weak wall in your cell and find your way out. There are just a few more things that you need to do before your escape.

The items you need are scattered around the prison. Some you can find, others you'll need to trade for. Talk to the other prisoners and see what they want.

The cell door is open - you can move freely around the prison.

Here are the controls:
 examine "something" - examines the item and tells you the description
 talk to "name" - start a conversation with someone
 eat "something" - try to eat something
 steal "something" from "someone" - steal a thing from someone

These are the basic actions you can do.

You can find other functions that you can do by examining right objects.
 GOOD LUCK! 
The prison break
An Interactive Fiction by Filip Svetlecic
Release 1 / Serial number 260118 / Inform 7 v10.1.2 / D

Cell
Your home for the past two years. Cold concrete walls surround you, with a rusty sink in the corner and a narrow bed.

north - hallway

An old stained sink with rusty pipes. Behind it, the wall looks suspiciously weak.

You can also see a cell door, a bed, a weak wall, a screwdriver, a cigarettes and a magazine here.

>pick
(up the torch)
Taken.

>north
You can't go that way.

>south
You can't go that way.

>east
You can't go that way.

>west
You can't go that way.

* * *

>look
Pit
This is the place you woke up. What a scary place!

You can see a torch here.

>pick up torch
Taken.

* * *

>south
First Janitor Room
A cramped storage space filled with cleaning supplies, mops, and buckets. A vent cover is mounted on the wall. There's a janitor uniform hanging on a hook. You can go back through the hole to the cell.

You can see a hole, a janitor uniform, a vent cover and a flashlight here.

>north
Cell
Your home for the past two years. Cold concrete walls surround you, with a rusty sink in the corner and a narrow bed. Behind the sink, you've spent months secretly weakening a section of wall. The cell door leads north to the hallway.

An old stained sink with rusty pipes. Behind it, the wall looks suspiciously weak.

Your cellmate Dimitri lies on his bunk, reading.

You can also see a hole, a cell door, a magazine and a narrow bed here.

>west
You can't go that way.

>east
You can't go that way.

>talk to dimitri
Dimitri looks up from his book. "Running low on smokes. You know where to find any?"

>go to cell
You can't see any such thing.

>go south
First Janitor Room
A cramped storage space filled with cleaning supplies, mops, and buckets. A vent cover is mounted on the wall. There's a janitor uniform hanging on a hook. You can go back through the hole to the cell.

You can see a hole, a janitor uniform, a vent cover and a flashlight here.

>go north
Cell
Your home for the past two years. Cold concrete walls surround you, with a rusty sink in the corner and a narrow bed. Behind the sink, you've spent months secretly weakening a section of wall. The cell door leads north to the hallway.

An old stained sink with rusty pipes. Behind it, the wall looks suspiciously weak.

Your cellmate Dimitri lies on his bunk, reading.

You can also see a hole, a cell door, a magazine and a narrow bed here.

* * *

>north
Hallway
A long, dimly lit corridor with flickering fluorescent lights.

north - cafeteria east - gym west - yard south - your cell 

Dimitri is suspiciously lurking in front of your cell. He is onto something

You can also see a cell door here.

>south
Cell
Your home for the past two years. Cold concrete walls surround you, with a rusty sink in the corner and a narrow bed. Behind the sink, you've spent months secretly weakening a section of wall. The cell door leads north to the hallway.

An old stained sink with rusty pipes. Behind it, the wall looks suspiciously weak.

Your cellmate Dimitri lies on his bunk, reading.

You can also see a cell door, a hole, a magazine and a narrow bed here.

>east
You can't go that way.

* * *

>west
You can't go that way.

>go to hallway
You can't see any such thing.

>enter hallway
You can't see any such thing.

>talk to dimitri
Dimitri looks up from his book. "Running low on smokes. You know where to find any?"

>pick up magazine
Taken.

>inventory
You are carrying:
  a magazine

>north
Hallway
A long, dimly lit corridor with flickering fluorescent lights. Cell doors line the walls. The hallway extends north to the cafeteria, east to the gym, and west to the yard. Your cell is to the south.

Old Pete sweeps the floor slowly, his janitor uniform worn and faded.

You can also see a cell door here.

>north
Cafeteria
A large room filled with metal tables and benches. The smell of institutional food lingers in the air. A serving counter sits against the far wall. The hallway is to the south.

Slick Tony sits at a corner table, shuffling a deck of cards.

You can also see a cigarettes, a playing cards and a chocolate bar here.

>take cigarettes
Taken.

>take playing cards
Taken.

>take chocolate bar
Taken.

>north
Infirmary
A small medical facility with white walls and the sharp smell of antiseptic. Medical supplies are locked away in cabinets. The cafeteria is to the south.

You can see a watch here.

>north
You can't go that way.

>south
Cafeteria
A large room filled with metal tables and benches. The smell of institutional food lingers in the air. A serving counter sits against the far wall. The hallway is to the south.

Slick Tony sits at a corner table, shuffling a deck of cards.

>north
Infirmary
A small medical facility with white walls and the sharp smell of antiseptic. Medical supplies are locked away in cabinets. The cafeteria is to the south.

You can see a watch here.

>east
You can't go that way.

* * *

>west
You can't go that way.

>south
Cafeteria
A large room filled with metal tables and benches. The smell of institutional food lingers in the air. A serving counter sits against the far wall. The hallway is to the south.

Slick Tony sits at a corner table, shuffling a deck of cards.

>south
Hallway
A long, dimly lit corridor with flickering fluorescent lights. Cell doors line the walls. The hallway extends north to the cafeteria, east to the gym, and west to the yard. Your cell is to the south.

Old Pete sweeps the floor slowly, his janitor uniform worn and faded.

You can also see a cell door here.

>north
Cafeteria
A large room filled with metal tables and benches. The smell of institutional food lingers in the air. A serving counter sits against the far wall. The hallway is to the south.

Slick Tony sits at a corner table, shuffling a deck of cards.

>south
Hallway
A long, dimly lit corridor with flickering fluorescent lights. Cell doors line the walls. The hallway extends north to the cafeteria, east to the gym, and west to the yard. Your cell is to the south.

Old Pete sweeps the floor slowly, his janitor uniform worn and faded.

You can also see a cell door here.

>south
Cell
Your home for the past two years. Cold concrete walls surround you, with a rusty sink in the corner and a narrow bed. Behind the sink, you've spent months secretly weakening a section of wall. The cell door leads north to the hallway.

An old stained sink with rusty pipes. Behind it, the wall looks suspiciously weak.

Your cellmate Dimitri lies on his bunk, reading.

You can also see a cell door, a hole and a narrow bed here.

>talk to dimitri
Dimitri looks up from his book. "Running low on smokes. You know where to find any?"

>trade cigarettes
(to Dimitri)
Dimitri sits up eagerly. "You're the best cellmate ever! Here, take this bar of soap. Got it from the commissary."

>north
Hallway
A long, dimly lit corridor with flickering fluorescent lights. Cell doors line the walls. The hallway extends north to the cafeteria, east to the gym, and west to the yard. Your cell is to the south.

Old Pete sweeps the floor slowly, his janitor uniform worn and faded.

You can also see a cell door here.

>east
Gym
Weight equipment and exercise machines fill this space. Prisoners come here to pass the time and stay strong. The hallway is to the west.

Viktor is doing pull-ups, his massive frame barely fitting in the space.

You can also see a protein powder and a rope here.

>take protein powder
Taken.

>take rope
Taken.

>inventory
You are carrying:
  a rope
  a protein powder
  a bar of soap
  a chocolate bar
  a playing cards
  a magazine

>south
You can't go that way.

>north
You can't go that way.

>east
You can't go that way.

I beg your pardon?

>west
Hallway
A long, dimly lit corridor with flickering fluorescent lights. Cell doors line the walls. The hallway extends north to the cafeteria, east to the gym, and west to the yard. Your cell is to the south.

Old Pete sweeps the floor slowly, his janitor uniform worn and faded.

You can also see a cell door here.

>east
Gym
Weight equipment and exercise machines fill this space. Prisoners come here to pass the time and stay strong. The hallway is to the west.

Viktor is doing pull-ups, his massive frame barely fitting in the space.

>talk to Viktor
Viktor says between reps, "Need protein powder, man. Get me some and I'll make it worth your while. I've got a hammer I don't need."

>trade proteing powder
You can't see any such thing.

>trade Viktor
(to Viktor)
Viktor grunts. "Don't need that. Bring me protein powder."

>trade Viktor protein poweder
I didn't understand that sentence.

>trade Viktor protein powder
I didn't understand that sentence.

* * *

>inspect weak wall
That's not a verb I recognise.

>examine weak wall
A section of wall behind the sink that you've been secretly weakening for months. With the right tool, you could break through.

* * *

>examine cell
You see nothing special about the cell door.

>examine magazine
An old magazine, well-thumbed. Good for trading or passing time.

* * *

>take magazine
Taken.

>move narrow bed
It is fixed in place.

>north
Hallway
A long, dimly lit corridor with flickering fluorescent lights. Cell doors line the walls. The hallway extends north to the cafeteria, east to the gym, and west to the yard. Your cell is to the south.

Old Pete sweeps the floor slowly, his janitor uniform worn and faded.

You can also see a cell door here.

>talk to pete
Old Pete sighs, "Been working here thirty years. Can't even remember what chocolate tastes like anymore. If you could find me some..."

>north
Cafeteria
A large room filled with metal tables and benches. The smell of institutional food lingers in the air. A serving counter sits against the far wall. The hallway is to the south.

Slick Tony sits at a corner table, shuffling a deck of cards.

You can also see a cigarettes, a playing cards and a chocolate bar here.

* * *

>take cigarettes
Taken.

>take playing card
I only understood you as far as wanting to take the playing cards.

>take cards
Taken.

>i
You are carrying:
  a playing cards
  a cigarettes
  a magazine

>take chocolate
Taken.

>i
You are carrying:
  a chocolate bar
  a playing cards
  a cigarettes
  a magazine

>sout
That's not a verb I recognise.

>south
Hallway
A long, dimly lit corridor with flickering fluorescent lights. Cell doors line the walls. The hallway extends north to the cafeteria, east to the gym, and west to the yard. Your cell is to the south.

Old Pete sweeps the floor slowly, his janitor uniform worn and faded.

You can also see a cell door here.

>trade pete
(to Old Pete)
Pete shakes his head. "No thanks. Unless you have chocolate..."

>trade chocolate to pete
Old Pete's face lights up. "Haven't had chocolate in years! Here, you can borrow these keys, but I need them back eventually." He hands you his keyring.

>i
You are carrying:
  a real keys
  a playing cards
  a cigarettes
  a magazine

>east
Gym
Weight equipment and exercise machines fill this space. Prisoners come here to pass the time and stay strong. The hallway is to the west.

Viktor is doing pull-ups, his massive frame barely fitting in the space.

You can also see a protein powder and a rope here.

* * *

>take protein powder
Taken.

>trade protein powder to Viktor
Viktor's eyes light up. "Perfect! Here, take this hammer. I lifted it from the workshop."

>west
Hallway
A long, dimly lit corridor with flickering fluorescent lights. Cell doors line the walls. The hallway extends north to the cafeteria, east to the gym, and west to the yard. Your cell is to the south.

Old Pete sweeps the floor slowly, his janitor uniform worn and faded.

You can also see a cell door here.

>south
Cell
Your home for the past two years. Cold concrete walls surround you, with a rusty sink in the corner and a narrow bed.

An old stained sink with rusty pipes. Behind it, the wall looks suspiciously weak.

Your cellmate Dimitri lies on his bunk, reading.

You can also see a cell door, a hole and a narrow bed here.

>break wall with hammer
You swing the hammer hard against the weak wall behind the sink. With a satisfying crack, chunks of concrete fall away, revealing a dark opening into the janitor's room beyond! You've done it!

>north
Hallway
A long, dimly lit corridor with flickering fluorescent lights. Cell doors line the walls. The hallway extends north to the cafeteria, east to the gym, and west to the yard. Your cell is to the south.

Old Pete sweeps the floor slowly, his janitor uniform worn and faded.

You can also see a cell door here.

>south
Cell
Your home for the past two years. Cold concrete walls surround you, with a rusty sink in the corner and a narrow bed.

An old stained sink with rusty pipes. Behind it, the wall looks suspiciously weak.

Your cellmate Dimitri lies on his bunk, reading.

You can also see a cell door, a hole and a narrow bed here.

* * *

>east
You can't go that way.

* * *

>west
You can't go that way.

>break weak wall with hammer
You've already broken through the wall.

* * *

>north
Hallway
A long, dimly lit corridor with flickering fluorescent lights. Cell doors line the walls. The hallway extends north to the cafeteria, east to the gym, and west to the yard. Your cell is to the south.

Old Pete sweeps the floor slowly, his janitor uniform worn and faded.

You can also see a cell door here.

* * *

>take magazine
Taken.

>i
You are carrying:
  a magazine

>north
Hallway
A long, dimly lit corridor with flickering fluorescent lights. Cell doors line the walls. The hallway extends north to the cafeteria, east to the gym, and west to the yard. Your cell is to the south.

Dimitri is suspiciously lurking in front of your cell. He is onto something

You can also see a cell door here.

>examine dimitri
Dimitri might know about your plan. Try to talk to him and make some kind of compromise.

>talk to dimitri
Dimitri says, "Do you really think you are that slick with your escape plan? Do you think I dont know about it? It would be a shame if I told the guards, right? Here is the thing, you steal that ring from that new guy Viktor, and give it to me. From then on, I don't know about escape plan."

>north
Cafeteria
A large room filled with metal tables and benches. The smell of institutional food lingers in the air. A serving counter sits against the far wall. The hallway is to the south.

Viktor is a new guy that had never been to prison. He doesn't really know about rules of the pod yet

You can also see a protein powder, an eggs and a milk here.

>take protein powder
Taken.

>take eggs
Taken.

>take milk
Taken.

>eaxmine viktor
That's not a verb I recognise.

>examine viktor
That golden ring is an interest of a lot of people here. Maybe you should consider getting that ring, or even stealing it...

>steal ring from viktor
You can't see any such thing.

* * *

>take magazine
Taken.

>north
Hallway
A long, dimly lit corridor with flickering fluorescent lights. Cell doors line the walls. The hallway extends north to the cafeteria, east to the gym, and west to the yard. Your cell is to the south.

Dimitri is suspiciously lurking in front of your cell. He is onto something

You can also see a cell door here.

>north
Cafeteria
A large room filled with metal tables and benches. The smell of institutional food lingers in the air. A serving counter sits against the far wall. The hallway is to the south.

Viktor is a new guy that had never been to prison. He doesn't really know about rules of the pod yet

You can also see a protein powder, an eggs and a milk here.

* * *

>take milk
Taken.

>steal ring from viktor
You can't see any such thing.

* * *

>take magazine
Taken.

>n
Hallway
A long, dimly lit corridor with flickering fluorescent lights. Cell doors line the walls. The hallway extends north to the cafeteria, east to the gym, and west to the yard. Your cell is to the south.

Dimitri is suspiciously lurking in front of your cell. He is onto something

You can also see a cell door here.

>n
Cafeteria
A large room filled with metal tables and benches. The smell of institutional food lingers in the air. A serving counter sits against the far wall. The hallway is to the south.

Viktor is a new guy that had never been to prison. He doesn't really know about rules of the pod yet

You can also see a protein powder, an eggs and a milk here.

>take protein powder
Taken.

>examine viktor
That golden ring is an interest of a lot of people here. Maybe you should consider getting that ring, or even stealing it...

>steal ring from viktor
You successfully steal the ring from Viktor. Get out of here before he realizes!

>n
Infirmary
A small medical facility with white walls and the sharp smell of antiseptic. Medical supplies are locked away in cabinets. The cafeteria is to the south.

Old Pete sweeps the floor slowly, his janitor uniform worn and faded.

>examine old pete
Pete has been a janitor here for decades. He knows every corner of this prison. He also has the important keys that can help you move around the prison. Ask him about the keys

>talk to old pete
Old Pete sighs, "Been working here thirty years. I hate this place. The only thing that is making me different from you are these keys that I have to carry. With them I can move around the prison. Just can't wait to leave them and lock them in the chest in Janitor Room and go home"

>n
You can't go that way.

>s
Cafeteria
A large room filled with metal tables and benches. The smell of institutional food lingers in the air. A serving counter sits against the far wall. The hallway is to the south.

Viktor is a new guy that had never been to prison. He doesn't really know about rules of the pod yet

You can also see an eggs and a milk here.

>e
You can't go that way.

>w
You can't go that way.

>s
Hallway
A long, dimly lit corridor with flickering fluorescent lights. Cell doors line the walls. The hallway extends north to the cafeteria, east to the gym, and west to the yard. Your cell is to the south.

Dimitri is suspiciously lurking in front of your cell. He is onto something

You can also see a cell door here.

>n
Cafeteria
A large room filled with metal tables and benches. The smell of institutional food lingers in the air. A serving counter sits against the far wall. The hallway is to the south.

Viktor is a new guy that had never been to prison. He doesn't really know about rules of the pod yet

You can also see an eggs and a milk here.

>n
Infirmary
A small medical facility with white walls and the sharp smell of antiseptic. Medical supplies are locked away in cabinets. The cafeteria is to the south.

Old Pete sweeps the floor slowly, his janitor uniform worn and faded.

>s
Cafeteria
A large room filled with metal tables and benches. The smell of institutional food lingers in the air. A serving counter sits against the far wall. The hallway is to the south.

Viktor is a new guy that had never been to prison. He doesn't really know about rules of the pod yet

You can also see an eggs and a milk here.

>s
Hallway
A long, dimly lit corridor with flickering fluorescent lights. Cell doors line the walls. The hallway extends north to the cafeteria, east to the gym, and west to the yard. Your cell is to the south.

Dimitri is suspiciously lurking in front of your cell. He is onto something

You can also see a cell door here.

>e
Gym
Weight equipment and exercise machines fill this space. Prisoners come here to pass the time and stay strong. The hallway is to the west.

Tony is doing pull-ups, his massive frame barely fitting in the space.

>examine tony
Tony is obsessed with working out and is always looking for protein powder or other supplements.

>talk to tony
Tony says, between the pull up sets, "I really need to get some protein powder. Do you have any? I will make you a good bargain and give you this flashlight that I took from an inmate"

>trade protein powder to Tony
Tony's eyes light up. "Perfect! Here, take this flashlight. I stole it from one inmate here."

>i
You are carrying:
  a flashlight
  a ring
  a magazine

>s
You can't go that way.

>n
You can't go that way.

>e
You can't go that way.

>w
Hallway
A long, dimly lit corridor with flickering fluorescent lights. Cell doors line the walls. The hallway extends north to the cafeteria, east to the gym, and west to the yard. Your cell is to the south.

Dimitri is suspiciously lurking in front of your cell. He is onto something

You can also see a cell door here.

>w
Yard
An outdoor recreation area surrounded by high concrete walls topped with barbed wire. Guard towers loom in the corners. The hallway is to the east.

Marko, the inmate who works in the maintenance. He mows the lawn, prunes trees, fixes stuff when they break

You can also see a cigarettes here.

>examine marko
Marko has a reputation for getting some tools from the warehouse

>talk to marko
Marko says, "I am running really low on cigarettes man. I am willing to trade the hammer for cigarettes.""

>e
Hallway
A long, dimly lit corridor with flickering fluorescent lights. Cell doors line the walls. The hallway extends north to the cafeteria, east to the gym, and west to the yard. Your cell is to the south.

Dimitri is suspiciously lurking in front of your cell. He is onto something

You can also see a cell door here.

>n
Cafeteria
A large room filled with metal tables and benches. The smell of institutional food lingers in the air. A serving counter sits against the far wall. The hallway is to the south.

Viktor is a new guy that had never been to prison. He doesn't really know about rules of the pod yet

You can also see an eggs and a milk here.

>talk to viktor
Viktor says, "Do you think I am fitting in in this prison? I am the new fish, how they like to say it. I will trade you playing cards for magazines"

>trade magazine to viktor
Viktor says. "Okay, those magazines for playing cards. Here you go"

>i
You are carrying:
  a playing cards
  a flashlight
  a ring

>s
Hallway
A long, dimly lit corridor with flickering fluorescent lights. Cell doors line the walls. The hallway extends north to the cafeteria, east to the gym, and west to the yard. Your cell is to the south.

Dimitri is suspiciously lurking in front of your cell. He is onto something

You can also see a cell door here.

>w
Yard
An outdoor recreation area surrounded by high concrete walls topped with barbed wire. Guard towers loom in the corners. The hallway is to the east.

Marko, the inmate who works in the maintenance. He mows the lawn, prunes trees, fixes stuff when they break

You can also see a cigarettes here.

>take cigarettes
Taken.

>trade cigarettes to Marko
Marko examines the ciggaretes and nods. "Alright, this'll do. Here's the hammer from the warehouse. What do you even need it for?"

>i
You are carrying:
  a hammer
  a playing cards
  a flashlight
  a ring

>e
Hallway
A long, dimly lit corridor with flickering fluorescent lights. Cell doors line the walls. The hallway extends north to the cafeteria, east to the gym, and west to the yard. Your cell is to the south.

Dimitri is suspiciously lurking in front of your cell. He is onto something

You can also see a cell door here.

>s
Cell
Your home for the past two years. Cold concrete walls surround you, with a rusty sink in the corner and a narrow bed.

An old stained sink with rusty pipes. Behind it, the wall looks suspiciously weak.

You can also see a cell door, a bed and a weak wall here.

>examine weak wall
A section of wall behind the sink that you've been secretly weakening for months. With the right tool, you could break through.

>break weak wall with hammer
You swing the hammer hard against the weakened wall. With a deafening crack, the concrete collapses, revealing a jagged hole leading into the janitor's room!

>w
You can't go that way.

>s
Janitor Room
A cramped storage space filled with cleaning supplies, mops, and buckets. A vent cover is mounted on the wall. There's a janitor uniform hanging on a hook. You can see the hole in the wall that leads back to your cell.

The keys that you need to escape are in this chest

A vent that leads into the ventilation. It is carefully screwed with 4 screws. You will need a screwdriver to unscrew them

You can also see a hole, a vent and a janitor uniform here.

>examine vent
Which do you mean, the vent or the vent cover?

>examine vent cover
You see nothing special about the vent cover.

>examine vent conver
You can't see any such thing.

>examine vent cover
You see nothing special about the vent cover.

>examine janitor room
I only understood you as far as wanting to examine the janitor uniform.

>janitor room
That's not a verb I recognise.

>take janitor uniform
Taken.

>examine chest
You see nothing special about the chest.

>open chest
It seems to be locked.

>pick a lock with paper clip
You can't see any such thing.

>pick lock with paper clip
You can't see any such thing.

>pick chest with paper clip
You can't see any such thing.

>pick chest with paper clip
You can't see any such thing.

>i
You are carrying:
  a janitor uniform
  a hammer
  a playing cards
  a flashlight
  a ring

>e
You can't go that way.

I beg your pardon?

>s
(first opening the vent)
It seems to be locked.

>n
Cell
Your home for the past two years. Cold concrete walls surround you, with a rusty sink in the corner and a narrow bed.

An old stained sink with rusty pipes. Behind it, the wall looks suspiciously weak.

You can also see a hole, a cell door and a bed here.

>shake bed
A paper clip just fell out of the bed and had been added to your inventory

>s
Janitor Room
A cramped storage space filled with cleaning supplies, mops, and buckets. A vent cover is mounted on the wall. There's a janitor uniform hanging on a hook. You can see the hole in the wall that leads back to your cell.

The keys that you need to escape are in this chest

A vent that leads into the ventilation. It is carefully screwed with 4 screws. You will need a screwdriver to unscrew them

You can also see a hole and a vent here.

>pick chest with paper clip
Good job! You picked the lock on the chest. It opens, revealing the keys. Take them and continue your escape plan.

>take keys
Taken.

>i
You are carrying:
  a keys
  a paper clip
  a janitor uniform
  a hammer
  a playing cards
  a flashlight
  a ring

>s
(first opening the vent)
It seems to be locked.

>unscrew vent
Which do you mean, the vent or the vent cover?

>unscrew the vent cover
Nothing obvious happens.

* * *

>n
Hallway
A long, dimly lit corridor with flickering fluorescent lights. 

north - cafeteria, 
 east - gym, 
 west - yard, 
 south - your cell

Dimitri is suspiciously lurking in front of your cell. He is onto something

You can also see a cell door here.

>n
Cafeteria
A large room filled with metal tables and benches. The smell of institutional food lingers in the air. A serving counter sits against the far wall. The hallway is to the south.

Viktor is a new guy that had never been to prison. You can tell that as he is showcasing his golden ring

You can also see a protein powder, an eggs and a milk here.

>take chocolaze
You can't see any such thing.

>take chocolate
Taken.

>s
Hallway
A long, dimly lit corridor with flickering fluorescent lights. Cell doors line the walls. The hallway extends north to the cafeteria, east to the gym, and west to the yard. Your cell is to the south.

Old Pete sweeps the floor slowly, his janitor uniform worn and faded.

You can also see a cell door here.

>trade chocolate ro Pete
I didn't understand that sentence.

>trade chocolate to Pete
Old Pete's face lights up. "Haven't had chocolate in years! Here, you can borrow these keys, but I need them back eventually." He hands you his keyring.

>e
Gym
Weight equipment and exercise machines fill this space. Prisoners come here to pass the time and stay strong. The hallway is to the west.

Viktor is doing pull-ups, his massive frame barely fitting in the space.

You can also see a protein powder and a rope here.

>take protein
Taken.

>trade protein to Viktor
Viktor's eyes light up. "Perfect! Here, take this hammer. I lifted it from the workshop."

>w
Hallway
A long, dimly lit corridor with flickering fluorescent lights. Cell doors line the walls. The hallway extends north to the cafeteria, east to the gym, and west to the yard. Your cell is to the south.

Old Pete sweeps the floor slowly, his janitor uniform worn and faded.

You can also see a cell door here.

>s
Cell
Your home for the past two years. Cold concrete walls surround you, with a rusty sink in the corner and a narrow bed.

An old stained sink with rusty pipes. Behind it, the wall looks suspiciously weak.

Your cellmate Dimitri lies on his bunk, reading.

You can also see a cell door, a hole, a magazine and a narrow bed here.

>brake wall with hammer
That's not a verb I recognise.

>brake weak wall with hammer
That's not a verb I recognise.

>brake weak-wall with hammer
That's not a verb I recognise.

>break wall with hammer
You swing the hammer hard against the weak wall behind the sink. With a satisfying crack, chunks of concrete fall away, revealing a dark opening into the janitor's room beyond! You've done it!

* * *

>north
Hallway
A long, dimly lit corridor with flickering fluorescent lights. Cell doors line the walls. The hallway extends north to the cafeteria, east to the gym, and west to the yard. Your cell is to the south.

Old Pete sweeps the floor slowly, his janitor uniform worn and faded.

You can also see a cell door here.

>south
Cell
Your home for the past two years. Cold concrete walls surround you, with a rusty sink in the corner and a narrow bed.

An old stained sink with rusty pipes. Behind it, the wall looks suspiciously weak.

Your cellmate Dimitri lies on his bunk, reading.

You can also see a cell door, a hole, a magazine and a narrow bed here.

>south
First Janitor Room
A cramped storage space filled with cleaning supplies, mops, and buckets. A vent cover is mounted on the wall. There's a janitor uniform hanging on a hook. You can see the hole in the wall that leads back to your cell.

You can see a hole, a janitor uniform, a vent cover and a flashlight here.

>take janitor uniform
Taken.

>take flashlight
Taken.

>north
Cell
Your home for the past two years. Cold concrete walls surround you, with a rusty sink in the corner and a narrow bed.

An old stained sink with rusty pipes. Behind it, the wall looks suspiciously weak.

Your cellmate Dimitri lies on his bunk, reading.

You can also see a hole, a cell door, a magazine and a narrow bed here.

>n
Hallway
A long, dimly lit corridor with flickering fluorescent lights. Cell doors line the walls. The hallway extends north to the cafeteria, east to the gym, and west to the yard. Your cell is to the south.

Old Pete sweeps the floor slowly, his janitor uniform worn and faded.

You can also see a cell door here.

>n
Cafeteria
A large room filled with metal tables and benches. The smell of institutional food lingers in the air. A serving counter sits against the far wall. The hallway is to the south.

Slick Tony sits at a corner table, shuffling a deck of cards.

You can also see a cigarettes and a playing cards here.

>n
Infirmary
A small medical facility with white walls and the sharp smell of antiseptic. Medical supplies are locked away in cabinets. The cafeteria is to the south.

You can see a watch here.

>take watch
Taken.

>s
Cafeteria
A large room filled with metal tables and benches. The smell of institutional food lingers in the air. A serving counter sits against the far wall. The hallway is to the south.

Slick Tony sits at a corner table, shuffling a deck of cards.

You can also see a cigarettes and a playing cards here.

>talk to tony
Tony says, "Always looking for new cards. These old ones are marked to hell. Bring me a fresh deck and I'll trade you something useful."

>i
You are carrying:
  a watch
  a flashlight
  a janitor uniform
  a hammer
  a real keys

>s
Hallway
A long, dimly lit corridor with flickering fluorescent lights. Cell doors line the walls. The hallway extends north to the cafeteria, east to the gym, and west to the yard. Your cell is to the south.

Old Pete sweeps the floor slowly, his janitor uniform worn and faded.

You can also see a cell door here.

>e
Gym
Weight equipment and exercise machines fill this space. Prisoners come here to pass the time and stay strong. The hallway is to the west.

Viktor is doing pull-ups, his massive frame barely fitting in the space.

You can also see a rope here.

>take rope
Taken.

>e
You can't go that way.

>s
You can't go that way.

>w
Hallway
A long, dimly lit corridor with flickering fluorescent lights. Cell doors line the walls. The hallway extends north to the cafeteria, east to the gym, and west to the yard. Your cell is to the south.

Old Pete sweeps the floor slowly, his janitor uniform worn and faded.

You can also see a cell door here.

>n
Cafeteria
A large room filled with metal tables and benches. The smell of institutional food lingers in the air. A serving counter sits against the far wall. The hallway is to the south.

Slick Tony sits at a corner table, shuffling a deck of cards.

You can also see a cigarettes and a playing cards here.

>w
You can't go that way.

>s
Hallway
A long, dimly lit corridor with flickering fluorescent lights. Cell doors line the walls. The hallway extends north to the cafeteria, east to the gym, and west to the yard. Your cell is to the south.

Old Pete sweeps the floor slowly, his janitor uniform worn and faded.

You can also see a cell door here.

>e
Gym
Weight equipment and exercise machines fill this space. Prisoners come here to pass the time and stay strong. The hallway is to the west.

Viktor is doing pull-ups, his massive frame barely fitting in the space.

>talk to viktor
Viktor says between reps, "Need protein powder, man. Get me some and I'll make it worth your while. I've got a hammer I don't need."

>s
You can't go that way.

* * *

>w
Hallway
A long, dimly lit corridor with flickering fluorescent lights. Cell doors line the walls. The hallway extends north to the cafeteria, east to the gym, and west to the yard. Your cell is to the south.

Old Pete sweeps the floor slowly, his janitor uniform worn and faded.

You can also see a cell door here.

>w
Yard
An outdoor recreation area surrounded by high concrete walls topped with barbed wire. Guard towers loom in the corners. The hallway is to the east.

Marko, the prison's unofficial pharmacist, leans against the wall watching everything.

You can also see a lighter here.

>talk to marko
Marko says, "I can get you medical supplies from the infirmary. Bring me a watch and we'll talk."

>trade watch to marko
Marko examines the watch and nods. "Alright, this'll do. Here's the medical gauze from the infirmary."

>take lighter
Taken.

>e
Hallway
A long, dimly lit corridor with flickering fluorescent lights. Cell doors line the walls. The hallway extends north to the cafeteria, east to the gym, and west to the yard. Your cell is to the south.

Old Pete sweeps the floor slowly, his janitor uniform worn and faded.

You can also see a cell door here.

>n
Cafeteria
A large room filled with metal tables and benches. The smell of institutional food lingers in the air. A serving counter sits against the far wall. The hallway is to the south.

Slick Tony sits at a corner table, shuffling a deck of cards.

You can also see a cigarettes and a playing cards here.

>take cigarettes
Taken.

* * *

>take playing cards
Taken.

>talk to tony
Tony says, "Always looking for new cards. These old ones are marked to hell. Bring me a fresh deck and I'll trade you something useful."

>trade playing cards to ton
You can't see any such thing.

>trade playing cards to tony
Tony grins. "These are better than my old deck! Here, have this screwdriver I won in a bet."

>s
Hallway
A long, dimly lit corridor with flickering fluorescent lights. Cell doors line the walls. The hallway extends north to the cafeteria, east to the gym, and west to the yard. Your cell is to the south.

Old Pete sweeps the floor slowly, his janitor uniform worn and faded.

You can also see a cell door here.

>talk to pete
Old Pete sighs, "Been working here thirty years. Can't even remember what chocolate tastes like anymore. If you could find me some..."

>trade chocolate bar to pete
You can't see any such thing.

>trade chocolate to pete
You can't see any such thing.

>i
You are carrying:
  a screwdriver
  a cigarettes
  a lighter
  a medical gauze
  a rope
  a flashlight
  a janitor uniform
  a hammer
  a real keys

>n
Cafeteria
A large room filled with metal tables and benches. The smell of institutional food lingers in the air. A serving counter sits against the far wall. The hallway is to the south.

Slick Tony sits at a corner table, shuffling a deck of cards.

>s
Hallway
A long, dimly lit corridor with flickering fluorescent lights. Cell doors line the walls. The hallway extends north to the cafeteria, east to the gym, and west to the yard. Your cell is to the south.

Old Pete sweeps the floor slowly, his janitor uniform worn and faded.

You can also see a cell door here.

>s
Cell
Your home for the past two years. Cold concrete walls surround you, with a rusty sink in the corner and a narrow bed.

An old stained sink with rusty pipes. Behind it, the wall looks suspiciously weak.

Your cellmate Dimitri lies on his bunk, reading.

You can also see a cell door, a hole, a magazine and a narrow bed here.

>talk to dimitri
Dimitri looks up from his book. "Running low on smokes. You know where to find any?"

>trade cigarettes to dimitri
Dimitri sits up eagerly. "You're the best cellmate ever! Here, take this bar of soap. Got it from the commissary."

>carve key from soap
Working carefully, you carve the bar of soap into a perfect replica of the janitor's key. It should work... at least once.

>s
First Janitor Room
A cramped storage space filled with cleaning supplies, mops, and buckets. A vent cover is mounted on the wall. There's a janitor uniform hanging on a hook. You can see the hole in the wall that leads back to your cell.

You can see a hole and a vent cover here.

>inspect vent cover
That's not a verb I recognise.

>examine vent cover
A metal vent cover held in place by four screws.

>unscrew vent
It is fixed in place.

>unscrew vent cover
It is fixed in place.

>loosen screws on vent  cover
You carefully unscrew the four screws holding the vent cover in place. It comes free with a metallic clank. The dark ventilation shaft beckons.

>climb into vent
Ventilation Shaft
A narrow metal duct. You can barely fit through here. The air is stale and dusty. You can see another vent opening ahead.

You hoist yourself up and crawl into the narrow ventilation shaft. It's a tight squeeze.

>s
You can't go that way.

* * *

>e
You can't go that way.

>w
First Janitor Room
A cramped storage space filled with cleaning supplies, mops, and buckets. A vent cover is mounted on the wall. There's a janitor uniform hanging on a hook. You can see the hole in the wall that leads back to your cell.

You can see a hole here.

>climb into vent
Ventilation Shaft
A narrow metal duct. You can barely fit through here. The air is stale and dusty. You can see another vent opening ahead.

You hoist yourself up and crawl into the narrow ventilation shaft. It's a tight squeeze.

>i
You are carrying:
  a soap key
  a screwdriver
  a lighter
  a medical gauze
  a rope
  a flashlight
  a janitor uniform
  a hammer
  a real keys

>wear a janitor uniform
You put on the janitor uniform. Now you look like you belong here... or at least like you work here.

>i
You are carrying:
  a soap key
  a screwdriver
  a lighter
  a medical gauze
  a rope
  a flashlight
  a janitor uniform (being worn)
  a hammer
  a real keys

>w
First Janitor Room
A cramped storage space filled with cleaning supplies, mops, and buckets. A vent cover is mounted on the wall. There's a janitor uniform hanging on a hook. You can see the hole in the wall that leads back to your cell.

You can see a hole here.

>e
Ventilation Shaft
A narrow metal duct. You can barely fit through here. The air is stale and dusty. You can see another vent opening ahead.

>climb into vent
There's no vent here to climb into.

>climb into ventilation
You can't see any such thing.

>e
You can't go that way.

* * *

>e
Ventilation Shaft
A narrow metal duct. You can barely fit through here. The air is stale and dusty. You can see another vent opening ahead.

>n
You can't go that way.

>s
You can't go that way.

>exit vent
Second Janitor Room
Another janitor's closet, similar to the first but closer to the prison exit. A door leads north to freedom. You can climb back into the vent.

You can see an exit door here.

You push open the vent cover on the other side and drop down into another janitor's closet. You're getting close to freedom!

>open door
It seems to be locked.

>w
You can't go that way.

>s
You can't go that way.

>e
You can't go that way.

>n
(first opening the exit door)
It seems to be locked.

>unlock door with soap key
You slide the soap key into the lock. It fits! You turn it carefully... click! The door unlocks. This is it. Freedom awaits!

>n
(first opening the exit door)

Prison Exit
Fresh air! The door to the outside world is just ahead. You can see the night sky through the window. Freedom is within reach.

You can see an exit door here.

    *** You step through the door into the cool night air. After two years of planning, you're finally free! The janitor uniform helps you blend in as you walk away from the prison. You've done it! ***

Would you like to RESTART, RESTORE a saved game, QUIT or UNDO the last command?

* * *

>n
Hallway
A long, dimly lit corridor with flickering fluorescent lights. 

north - cafeteria, 
 east - gym, 
 west - yard, 
 south - your cell

Dimitri is suspiciously lurking in front of your cell. He is onto something

You can also see a cell door here.

>talk to Pete
Old Pete sighs, "Been working here thirty years. Can't even remember what chocolate tastes like anymore. If you could find me some..."

* * *

>n
Hallway
A long, dimly lit corridor with flickering fluorescent lights. 

north - cafeteria, 
 east - gym, 
 west - yard, 
 south - your cell

Dimitri is suspiciously lurking in front of your cell. He is onto something

You can also see a cell door here.

>talk to pete
Old Pete sighs, "Been working here thirty years. I hate this place. The only valuable thing in my life is this key that I have to carry around everywhere."
You can ask Old Pete about his keys or  if you want to know more information about them

>ask Pete about keys
There is no reply.

>ask Old Pete about keys
There is no reply.

>ask Old Pete about keys
There is no reply.

>ask Pete about keys
There is no reply.

>ask Pete about key
There is no reply.

* * *

>talk to pete
Old Pete sighs, "Been working here thirty years. I hate this place. The only valuable thing in my life is this key that I have to carry around everywhere."
You can ask Old Pete about his keys or  if you want to know more information about them

>ask pete about keys
There is no reply.

* * *

>n
Hallway
A long, dimly lit corridor with flickering fluorescent lights. 

north - cafeteria, 
 east - gym, 
 west - yard, 
 south - your cell

Dimitri is suspiciously lurking in front of your cell. He is onto something

You can also see a cell door here.

>s
Cell
Your home for the past two years. Cold concrete walls surround you, with a rusty sink in the corner and a narrow bed.

north - hallway

An old stained sink with rusty pipes. Behind it, the wall looks suspiciously weak.

You can also see a cell door, a bed, a weak wall, a screwdriver, a cigarettes and a magazine here.

>take screwdriver
Taken.

>take cigarettes
Taken.

>take magazine
Taken.

>n
Hallway
A long, dimly lit corridor with flickering fluorescent lights.

north - cafeteria, east - gym, west - yard, south - your cell 

Dimitri is suspiciously lurking in front of your cell. He is onto something

You can also see a cell door here.

>n
Cafeteria
A large room filled with metal tables and benches. The smell of institutional food lingers in the air. A serving counter sits against the far wall.

north - infirmary south - hallway

Viktor is a new guy that had never been to prison. He doesn't really know about rules of the pod yet

You can also see a protein powder, an eggs and a milk here.

>steal ring from viktor
You successfully steal the ring from Viktor. Get out of here before he realizes!

>take protein powder
Taken.

* * *

>take milk
Taken.

>eat eggs
You eat the eggs. Not bad.

>i
You are carrying:
  a milk
  a protein powder
  a ring
  a magazine
  a cigarettes
  a screwdriver

>eat milk
You eat the milk. Not bad.

>n
Infirmary
A small medical facility with white walls and the sharp smell of antiseptic. Medical supplies are locked away in cabinets.

south - cafeteria 

Old Pete sweeps the floor slowly, his janitor uniform worn and faded.

>s
Cafeteria
A large room filled with metal tables and benches. The smell of institutional food lingers in the air. A serving counter sits against the far wall.

north - infirmary south - hallway

Viktor is a new guy that had never been to prison. He doesn't really know about rules of the pod yet

>s
Hallway
A long, dimly lit corridor with flickering fluorescent lights.

north - cafeteria, east - gym, west - yard, south - your cell 

Dimitri is suspiciously lurking in front of your cell. He is onto something

You can also see a cell door here.

>w
Yard
An outdoor recreation area surrounded by high concrete walls topped with barbed wire. Guard towers loom in the corners.

east - hallway 

Marko, the inmate who works in the maintenance. He mows the lawn, prunes trees, fixes stuff when they break

>talk to marko
Marko says, "I am running really low on cigarettes man. I am willing to trade the hammer for cigarettes.""

>trade cigarettes to marko
Marko examines the ciggaretes and nods. "Alright, this'll do. Here's the hammer from the warehouse. What do you even need it for?"

>e
Hallway
A long, dimly lit corridor with flickering fluorescent lights.

north - cafeteria, east - gym, west - yard, south - your cell 

Dimitri is suspiciously lurking in front of your cell. He is onto something

You can also see a cell door here.

>s
Cell
Your home for the past two years. Cold concrete walls surround you, with a rusty sink in the corner and a narrow bed.

north - hallway

An old stained sink with rusty pipes. Behind it, the wall looks suspiciously weak.

You can also see a cell door, a bed and a weak wall here.

>i
You are carrying:
  a hammer
  a protein powder
  a ring
  a magazine
  a screwdriver

>shake bed
A paper clip just fell out of the bed and had been added to your inventory

>brake weak wall with hammer
That's not a verb I recognise.

>brerak weak wall with hammer
That's not a verb I recognise.

>brerak wall with hammer
That's not a verb I recognise.

>break wall with hammer
You swing the hammer hard against the weakened wall. With a deafening crack, the concrete collapses, revealing a jagged hole leading into the janitor's room!

>open chest
You can't see any such thing.

>examine room
You can't see any such thing.

>s
Janitor Room
A cramped storage space filled with cleaning supplies, mops, and buckets. A vent cover is mounted on the wall. There's a janitor uniform hanging on a hook. You can see the hole in the wall that leads back to your cell.

north - cell south - ventilation 

The keys that you need to escape are in this chest

A vent that leads into the ventilation. It is carefully screwed with 4 screws. You will need a screwdriver to unscrew them

You can also see a hole and a janitor uniform here.

>examine chest
You see nothing special about the chest.

* * *

>open chest
It seems to be locked.

>pick chest with paper clip
Good job! You picked the lock on the chest. It opens, revealing the keys. Take them and continue your escape plan.

* * *

>take keys
Taken.

>n
Cell
Your home for the past two years. Cold concrete walls surround you, with a rusty sink in the corner and a narrow bed.

north - hallway

An old stained sink with rusty pipes. Behind it, the wall looks suspiciously weak.

You can also see a hole, a cell door and a bed here.

>s
Janitor Room
A cramped storage space filled with cleaning supplies, mops, and buckets. A vent cover is mounted on the wall. There's a janitor uniform hanging on a hook. You can see the hole in the wall that leads back to your cell.

north - cell south - ventilation 

The keys that you need to escape are in this chest

A vent that leads into the ventilation. It is carefully screwed with 4 screws. You will need a screwdriver to unscrew them

You can also see a hole and a janitor uniform here.

>tke janitor uniform
That's not a verb I recognise.

>take janitor
Taken.

>unscrew vent
(the vent cover)
Nothing obvious happens.

>unscrew the vent conver
You can't see any such thing.

>unscrew the vent cover
Nothing obvious happens.

>unscrew the vent cover
Nothing obvious happens.

I beg your pardon?

>loosen screws on vent cover
You carefully unscrew the four screws holding the vent cover in place. It comes free with a metallic clank. The dark ventilation shaft beckons.

>n
Cell
Your home for the past two years. Cold concrete walls surround you, with a rusty sink in the corner and a narrow bed.

north - hallway

An old stained sink with rusty pipes. Behind it, the wall looks suspiciously weak.

You can also see a hole, a cell door and a bed here.

>s
Janitor Room
A cramped storage space filled with cleaning supplies, mops, and buckets. A vent cover is mounted on the wall. There's a janitor uniform hanging on a hook. You can see the hole in the wall that leads back to your cell.

north - cell south - ventilation 

The keys that you need to escape are in this chest

You can also see a hole and a vent here.

>s
(first opening the vent)
It seems to be locked.

>e
Ventilation Shaft
A narrow metal duct. You can barely fit through here. The air is stale and dusty. You can see another vent opening ahead.

This is an exit vent from which you can exit the ventilation. It is carefully screwed with 4 screws. You will need a screwdriver to unscrew them

You can also see a vent and an exiting vent here.

>examine exitingvent
You can't see any such thing.

>examine exiting vent
You see nothing special about the exiting vent.

* * *

>n
Hallway
A long, dimly lit corridor with flickering fluorescent lights. 

north - cafeteria, 
 east - gym, 
 west - yard, 
 south - your cell

Dimitri is suspiciously lurking in front of your cell. He is onto something

You can also see a cell door here.

>trade ring to dimitri
You can't see any such thing.

>trade ring to dimitri
You can't see any such thing.

>n
Cafeteria
A large room filled with metal tables and benches. The smell of institutional food lingers in the air. A serving counter sits against the far wall.

north - infirmary, 
 south - hallway

Viktor is a new guy that had never been to prison. He doesn't really know about rules of the pod yet

You can also see a protein powder, an eggs and a milk here.

>steal ring from viktor
You successfully steal the ring from Viktor. Get out of here before he realizes!

>s
Hallway
A long, dimly lit corridor with flickering fluorescent lights. 

north - cafeteria, 
 east - gym, 
 west - yard, 
 south - your cell

Dimitri is suspiciously lurking in front of your cell. He is onto something

You can also see a cell door here.

>trade ring to dimitri
Dimitri grins. "Okay, this should do it. I dont know anything from now on. Good luck with your escape"

* * *

>examine bed
A mattress on which you spent countless nights. Try shaking it with a command: shake bed

>shake the bed
A paper clip just fell out of the bed and had been added to your inventory

>i
You are carrying:
  a paper clip

* * *

>examine bed
A mattress on which you spent countless nights. Try shaking it with a command: shake bed

>shake bed
A paper clip just fell out of the bed and had been added to your inventory

>i
You are carrying:
  a paper clip

>examine paper clip
A paper clip that you pick a lock with. You can pick a lock with this command: pick "something" with paper clip or open "something" with paper clip

>examine cell
You see nothing special about the cell door.

>n
Hallway
A long, dimly lit corridor with flickering fluorescent lights. 

north - cafeteria, 
 east - gym, 
 west - yard, 
 south - your cell 

Dimitri is suspiciously lurking in front of your cell. He is onto something

You can also see a cell door here.

>s
Cell
Your home for the past two years. Cold concrete walls surround you, with a rusty sink in the corner and a narrow bed.

north - hallway

An old stained sink with rusty pipes. Behind it, the wall looks suspiciously weak.

You can also see a cell door, a bed, a weak wall, a screwdriver, a cigarettes and a magazine here.

>examine screwdriver
A flathead screwdriver, useful for loosening screws. You can try loosening the screws with command: loosen screws on "something"

>take screwdriver
Taken.

* * *

>take magazine
Taken.

>s
Dimitri blocks your way. "Not so fast! You think I'm letting you escape without that ring? Bring me Viktor's ring first, or I'm calling the guards."

* * *

>shake bed
A paper clip just fell out of the bed and had been added to your inventory

>take screwdriver
Taken.

>examine screwdriver
A flathead screwdriver, useful for loosening screws. You can try loosening the screws with command: loosen screws on "something" or loosen "something"

>take cigarettes
Taken.

>examine weak wall
A section of wall behind the sink that you've been secretly weakening for months. With the right tool, you could break through.

>north
Hallway
A long, dimly lit corridor with flickering fluorescent lights. 

north - cafeteria, 
 east - gym, 
 west - yard, 
 south - your cell

Dimitri is suspiciously lurking in front of your cell. He is onto something

You can also see a cell door here.

>talk to Dimitri
Dimitri says, "Do you really think you are that slick with your escape plan? Do you think I dont know about it? It would be a shame if I told the guards, right? Here is the thing, you steal that ring from that new guy Viktor, and give it to me. From then on, I don't know about escape plan."

>north
Cafeteria
A large room filled with metal tables and benches. The smell of institutional food lingers in the air. A serving counter sits against the far wall.

north - infirmary, 
 south - hallway

Viktor is a new guy that had never been to prison. He doesn't really know about rules of the pod yet

You can also see a protein powder, an eggs and a milk here.

>examine Viktor
That golden ring is an interest of a lot of people here. Maybe you should consider getting that ring, or even stealing it...

>steal ring from viktor
You successfully steal the ring from Viktor. Get out of here before he realizes!

* * *

>trade ring to dimitri
Dimitri grins. "Okay, this should do it. I dont know anything from now on. Good luck with your escape"

>i
You are carrying:
  a cigarettes
  a screwdriver
  a paper clip

>n
Cafeteria
A large room filled with metal tables and benches. The smell of institutional food lingers in the air. A serving counter sits against the far wall.

north - infirmary, 
 south - hallway

Viktor is a new guy that had never been to prison. He doesn't really know about rules of the pod yet

You can also see a protein powder, an eggs and a milk here.

>take protein powder
Taken.

>s
Hallway
A long, dimly lit corridor with flickering fluorescent lights. 

north - cafeteria, 
 east - gym, 
 west - yard, 
 south - your cell

Dimitri is suspiciously lurking in front of your cell. He is onto something

You can also see a cell door here.

>w
Yard
An outdoor recreation area surrounded by high concrete walls topped with barbed wire. Guard towers loom in the corners. 

east - hallway

Marko, the inmate who works in the maintenance. He mows the lawn, prunes trees, fixes stuff when they break

>talk to Marko
Marko says, "I am running really low on cigarettes man. I am willing to trade the hammer for cigarettes.""

>trade cigarettes to marko
Marko examines the ciggaretes and nods. "Alright, this'll do. Here's the hammer from the warehouse. What do you even need it for?"

>i
You are carrying:
  a hammer
  a protein powder
  a screwdriver
  a paper clip

>e
Hallway
A long, dimly lit corridor with flickering fluorescent lights. 

north - cafeteria, 
 east - gym, 
 west - yard, 
 south - your cell

Dimitri is suspiciously lurking in front of your cell. He is onto something

You can also see a cell door here.

>e
Gym
Weight equipment and exercise machines fill this space. Prisoners come here to pass the time and stay strong.

west - hallway

Tony is doing pull-ups, his massive frame barely fitting in the space.

>trade proteing powder to tony
You can't see any such thing.

>trade protein powder to tony
Tony's eyes light up. "Perfect! Here, take this flashlight. I stole it from one inmate here."

>w
Hallway
A long, dimly lit corridor with flickering fluorescent lights. 

north - cafeteria, 
 east - gym, 
 west - yard, 
 south - your cell

Dimitri is suspiciously lurking in front of your cell. He is onto something

You can also see a cell door here.

>s
Cell
Your home for the past two years. Cold concrete walls surround you, with a rusty sink in the corner and a narrow bed.

north - hallway

An old stained sink with rusty pipes. Behind it, the wall looks suspiciously weak.

You can also see a cell door, a bed, a weak wall and a magazine here.

>break a weak wall
Violence isn't the answer to this one.

>break weak wall with hammer
You swing the hammer hard against the weakened wall. With a deafening crack, the concrete collapses, revealing a jagged hole leading into the janitor's room! Go south through the hole to enter janitor room.

>s
Janitor Room
A cramped storage space filled with cleaning supplies, mops, and buckets. A vent cover is mounted on the wall. There's a janitor uniform hanging on a hook. You can see the hole in the wall that leads back to your cell.

north - cell, 
 south - ventilation

The keys that you need to escape are in this chest

The vent cover that leads into the ventilation. It is carefully screwed with 4 screws. You will need a screwdriver to unscrew them

You can also see a hole and a janitor uniform here.

>take janitor uniform
Taken.

>pick lock on chest with paper clip
Good job! You picked the lock on the chest. It opens, revealing the keys. Take them and continue your escape plan.

>take keys
Taken.

>examine vent cover
You see nothing special about the vent cover.

>examine screwdriver
A flathead screwdriver, useful for loosening screws. You can try loosening the screws with command: loosen screws on "something" or loosen "something"

>loosen vent cover
You carefully unscrew the four screws holding the vent cover in place. It comes free with a metallic clank. The dark ventilation shaft beckons.

Go south to enter the ventilation shaft.

>s
Darkness
It is pitch dark, and you can't see a thing.

>s
It's too dark to continue south. You can't see where you're going! Try turning on the flashlight

I beg your pardon?

>turn on flashlight
You turn on your flashlight, and the beam reveals an exit that leads to garage. Go south to get to garage

>s
You have to wear a janitor uniform before you get into garage so you don't get caught

>wear janitor uniform
You put on the janitor uniform.

>s
Garage
A space that stores lawnmovers, tree cutters and everything needed to keep the prison yard clean. This room is very close to the exit. As a matter of fact, the doors, your way out, are to the south. You can climb back into the vent.

north - vent,
 south - freedom

You can see an exit vent and an exit door here.

>open exit door with keys
You unlock the exit door.

>s
(first opening the exit door)

    *** You unlock the door, step through, and escape. You win! ***

Would you like to RESTART, RESTORE a saved game, QUIT or UNDO the last command?

* * *

>shake the bed
A paper clip just fell out of the bed and had been added to your inventory

* * *

>i
You are carrying:
  a paper clip

>examine bed
A mattress on which you spent countless nights. It is very old, so try shaking it, maybe something will fall out.

>i
You are carrying:
  a paper clip

>shake the bed
A paper clip just fell out of the bed and had been added to your inventory

* * *

>i
You are carrying:
  a paper clip

>examine paper clip
A paper clip that you could possibly break the lock with

* * *

>s
You can't go that way.

>n
Hallway
A long, dimly lit corridor with flickering fluorescent lights. Cell doors line the walls. The hallway extends north to the cafeteria, east to the gym, and west to the yard. Your cell is to the south.

Dimitri is suspiciously lurking in front of your cell. He is onto something

You can also see a cell door here.

>s
Cell
Your home for the past two years. Cold concrete walls surround you, with a rusty sink in the corner and a narrow bed.

An old stained sink with rusty pipes. Behind it, the wall looks suspiciously weak.

You can also see a cell door, a bed, a weak wall, a screwdriver, a cigarettes and a magazine here.

* * *

>take a screwdriver
Taken.

>take cigarettes
Taken.

* * *

>take magazine
Taken.

>shake bed
A paper clip just fell out of the bed and had been added to your inventory

>i
You are carrying:
  a paper clip
  a magazine
  a cigarettes
  a screwdriver

>n
Hallway
A long, dimly lit corridor with flickering fluorescent lights. Cell doors line the walls. The hallway extends north to the cafeteria, east to the gym, and west to the yard. Your cell is to the south.

Dimitri is suspiciously lurking in front of your cell. He is onto something

You can also see a cell door here.

* * *

>n
Cafeteria
A large room filled with metal tables and benches. The smell of institutional food lingers in the air. A serving counter sits against the far wall. The hallway is to the south.

Viktor is a new guy that had never been to prison. He doesn't really know about rules of the pod yet

You can also see a protein powder, an eggs and a milk here.

>n
Infirmary
A small medical facility with white walls and the sharp smell of antiseptic. Medical supplies are locked away in cabinets. The cafeteria is to the south.

Old Pete sweeps the floor slowly, his janitor uniform worn and faded.

>s
Cafeteria
A large room filled with metal tables and benches. The smell of institutional food lingers in the air. A serving counter sits against the far wall. The hallway is to the south.

Viktor is a new guy that had never been to prison. He doesn't really know about rules of the pod yet

You can also see a protein powder, an eggs and a milk here.

>take protein powder eggs and milk
I only understood you as far as wanting to take the protein powder.

>take protein powder
Taken.

* * *

>take milk
Taken.

>steal ring from viktor
You successfully steal the ring from Viktor. Get out of here before he realizes!

>s
Hallway
A long, dimly lit corridor with flickering fluorescent lights. Cell doors line the walls. The hallway extends north to the cafeteria, east to the gym, and west to the yard. Your cell is to the south.

Dimitri is suspiciously lurking in front of your cell. He is onto something

You can also see a cell door here.

>s
Cell
Your home for the past two years. Cold concrete walls surround you, with a rusty sink in the corner and a narrow bed.

An old stained sink with rusty pipes. Behind it, the wall looks suspiciously weak.

You can also see a cell door, a bed and a weak wall here.

>n
Hallway
A long, dimly lit corridor with flickering fluorescent lights. Cell doors line the walls. The hallway extends north to the cafeteria, east to the gym, and west to the yard. Your cell is to the south.

Dimitri is suspiciously lurking in front of your cell. He is onto something

You can also see a cell door here.

>w
Yard
An outdoor recreation area surrounded by high concrete walls topped with barbed wire. Guard towers loom in the corners. The hallway is to the east.

Marko, the inmate who works in the maintenance. He mows the lawn, prunes trees, fixes stuff when they break

>talk to marko
Marko says, "I am running really low on cigarettes man. I am willing to trade the hammer for cigarettes.""

>i
You are carrying:
  a ring
  a milk
  an eggs
  a protein powder
  a paper clip
  a magazine
  a cigarettes
  a screwdriver

>trade cigarettes to marko
Marko examines the ciggaretes and nods. "Alright, this'll do. Here's the hammer from the warehouse. What do you even need it for?"

>s
You can't go that way.

>w
You can't go that way.

>n
You can't go that way.

>e
Hallway
A long, dimly lit corridor with flickering fluorescent lights. Cell doors line the walls. The hallway extends north to the cafeteria, east to the gym, and west to the yard. Your cell is to the south.

Dimitri is suspiciously lurking in front of your cell. He is onto something

You can also see a cell door here.

>w
Yard
An outdoor recreation area surrounded by high concrete walls topped with barbed wire. Guard towers loom in the corners. The hallway is to the east.

Marko, the inmate who works in the maintenance. He mows the lawn, prunes trees, fixes stuff when they break

>s
You can't go that way.

>s
You can't go that way.

* * *

>w
Yard
An outdoor recreation area surrounded by high concrete walls topped with barbed wire. Guard towers loom in the corners. The hallway is to the east.

Marko, the inmate who works in the maintenance. He mows the lawn, prunes trees, fixes stuff when they break

>e
Hallway
A long, dimly lit corridor with flickering fluorescent lights. Cell doors line the walls. The hallway extends north to the cafeteria, east to the gym, and west to the yard. Your cell is to the south.

Dimitri is suspiciously lurking in front of your cell. He is onto something

You can also see a cell door here.

* * *

>s
You can't go that way.

>e
Hallway
A long, dimly lit corridor with flickering fluorescent lights. Cell doors line the walls. The hallway extends north to the cafeteria, east to the gym, and west to the yard. Your cell is to the south.

Dimitri is suspiciously lurking in front of your cell. He is onto something

You can also see a cell door here.

>e
Gym
Weight equipment and exercise machines fill this space. Prisoners come here to pass the time and stay strong. The hallway is to the west.

Tony is doing pull-ups, his massive frame barely fitting in the space.

>talk to tony
Tony says, between the pull up sets, "I really need to get some protein powder. Do you have any? I will make you a good bargain and give you this flashlight that I took from an inmate"

>trade flashlight to tony
You can't see any such thing.

>trade protein powder to tony
Tony's eyes light up. "Perfect! Here, take this flashlight. I stole it from one inmate here."

>w
Hallway
A long, dimly lit corridor with flickering fluorescent lights. Cell doors line the walls. The hallway extends north to the cafeteria, east to the gym, and west to the yard. Your cell is to the south.

Dimitri is suspiciously lurking in front of your cell. He is onto something

You can also see a cell door here.

>s
Cell
Your home for the past two years. Cold concrete walls surround you, with a rusty sink in the corner and a narrow bed.

An old stained sink with rusty pipes. Behind it, the wall looks suspiciously weak.

You can also see a cell door, a bed and a weak wall here.

>break weak wall with hammer
You swing the hammer hard against the weakened wall. With a deafening crack, the concrete collapses, revealing a jagged hole leading into the janitor's room!

>n
Hallway
A long, dimly lit corridor with flickering fluorescent lights. Cell doors line the walls. The hallway extends north to the cafeteria, east to the gym, and west to the yard. Your cell is to the south.

Dimitri is suspiciously lurking in front of your cell. He is onto something

You can also see a cell door here.

>s
Cell
Your home for the past two years. Cold concrete walls surround you, with a rusty sink in the corner and a narrow bed.

An old stained sink with rusty pipes. Behind it, the wall looks suspiciously weak.

You can also see a cell door, a hole and a bed here.

>s
Janitor Room
A cramped storage space filled with cleaning supplies, mops, and buckets. A vent cover is mounted on the wall. There's a janitor uniform hanging on a hook. You can see the hole in the wall that leads back to your cell.

The keys that you need to escape are in this chest

A vent that leads into the ventilation. It is carefully screwed with 4 screws. You will need a screwdriver to unscrew them

You can also see a hole and a janitor uniform here.

>pick crate with paper clip
You can't see any such thing.

>pick chest with paper clip
Good job! You picked the lock on the chest. It opens, revealing the keys. Take them and continue your escape plan.

* * *

>take keys
Taken.

>i
You are carrying:
  a keys
  a flashlight
  a hammer
  a ring
  a milk
  an eggs
  a paper clip
  a magazine
  a screwdriver

>take janitor uniform
Taken.

>examine vent cover
You see nothing special about the vent cover.

>unscrew the vent cover
Nothing obvious happens.

>unscrew vent cover
Nothing obvious happens.

>loosen screws on vent cover\n
You can't see any such thing.

>unscrew the vent cover
Nothing obvious happens.

* * *

>unscrew vent cover
Nothing obvious happens.

>unscrew vent
(the vent cover)
Nothing obvious happens.

>unscrew the vent cover
Nothing obvious happens.

>i
You are carrying:
  a janitor uniform
  a keys
  a flashlight
  a hammer
  a ring
  a milk
  an eggs
  a paper clip
  a magazine
  a screwdriver

>loosen screws on vent cover
You carefully unscrew the four screws holding the vent cover in place. It comes free with a metallic clank. The dark ventilation shaft beckons.

>n
Cell
Your home for the past two years. Cold concrete walls surround you, with a rusty sink in the corner and a narrow bed.

An old stained sink with rusty pipes. Behind it, the wall looks suspiciously weak.

You can also see a hole, a cell door and a bed here.

>s
Janitor Room
A cramped storage space filled with cleaning supplies, mops, and buckets. A vent cover is mounted on the wall. There's a janitor uniform hanging on a hook. You can see the hole in the wall that leads back to your cell.

The keys that you need to escape are in this chest

You can also see a hole and a vent here.

>s
(first opening the vent)
It seems to be locked.

>e
Ventilation Shaft
A narrow metal duct. You can barely fit through here. The air is stale and dusty. You can see another vent opening ahead.

You can see a vent and an exiting vent here.

>turn on flashlight
It isn't something you can switch.

>unscrew the exiting vent
It is fixed in place.

>loosen screws on the exiting vent
There are no screws on that.

>loosen screws on the exiting vent cover
I only understood you as far as wanting to loosen screws on the exiting vent.

>loosen screws on the exit vent cover
There are no screws on that.

>loosen screws on exit vent cover
There are no screws on that.

>switch on flashlight
It isn't something you can switch.

* * *

>take screwdriver
Taken.

* * *

>take magazine
Taken.

>examine bed
A mattress on which you spent countless nights. It is very old, so try shaking it, maybe something will fall out.

>shake bed
A paper clip just fell out of the bed and had been added to your inventory

>examine cell door
You see nothing special about the cell door.

>n
Hallway
A long, dimly lit corridor with flickering fluorescent lights.

north - cafeteria, east - gym, west - yard, south - your cell 

Dimitri is suspiciously lurking in front of your cell. He is onto something

You can also see a cell door here.

>examine Dimitri
Dimitri might know about your plan. Try to talk to him and make some kind of compromise.

>talk to Dimitri
Dimitri says, "Do you really think you are that slick with your escape plan? Do you think I dont know about it? It would be a shame if I told the guards, right? Here is the thing, you steal that ring from that new guy Viktor, and give it to me. From then on, I don't know about escape plan."

>n
Cafeteria
A large room filled with metal tables and benches. The smell of institutional food lingers in the air. A serving counter sits against the far wall.

north - infirmary, south - hallway

Viktor is a new guy that had never been to prison. He doesn't really know about rules of the pod yet

You can also see a protein powder, an eggs and a milk here.

>take protein powder
Taken.

* * *

>take milk
Taken.

>i
You are carrying:
  a milk
  an eggs
  a protein powder
  a paper clip
  a magazine
  a cigarettes
  a screwdriver

>examine viktor
That golden ring is an interest of a lot of people here. Maybe you should consider getting that ring, or even stealing it...

>talk to viktor
Viktor says, "Do you think I am fitting in in this prison? I am the new fish, how they like to say it. I will trade you playing cards for magazines"

>trade playing cards to viktor
You can't see any such thing.

>i
You are carrying:
  a milk
  an eggs
  a protein powder
  a paper clip
  a magazine
  a cigarettes
  a screwdriver

>steal ring from viktor
You successfully steal the ring from Viktor. Get out of here before he realizes!

>s
Hallway
A long, dimly lit corridor with flickering fluorescent lights.

north - cafeteria, east - gym, west - yard, south - your cell 

Dimitri is suspiciously lurking in front of your cell. He is onto something

You can also see a cell door here.

>trade ring to dimitri
Dimitri grins. "Okay, this should do it. I dont know anything from now on. Good luck with your escape"

>e
Gym
Weight equipment and exercise machines fill this space. Prisoners come here to pass the time and stay strong.

west - hallway 

Tony is doing pull-ups, his massive frame barely fitting in the space.

>talk to tony
Tony says, between the pull up sets, "I really need to get some protein powder. Do you have any? I will make you a good bargain and give you this flashlight that I took from an inmate"

>trade protein powder to tony
Tony's eyes light up. "Perfect! Here, take this flashlight. I stole it from one inmate here."

>turn on flashlight
You turn on your flashlight, and the beam reveals a cover vent in front of you. You should try unscrewing the screws and seeing where it leads.

>turn off flashlight
You switch the flashlight off.

>w
Hallway
A long, dimly lit corridor with flickering fluorescent lights.

north - cafeteria, east - gym, west - yard, south - your cell 

Dimitri is suspiciously lurking in front of your cell. He is onto something

You can also see a cell door here.

>w
Yard
An outdoor recreation area surrounded by high concrete walls topped with barbed wire. Guard towers loom in the corners.

east - hallway 

Marko, the inmate who works in the maintenance. He mows the lawn, prunes trees, fixes stuff when they break

* * *

>talk to marko
Marko says, "I am running really low on cigarettes man. I am willing to trade the hammer for cigarettes.""

>i
You are carrying:
  a flashlight
  a milk
  an eggs
  a paper clip
  a magazine
  a cigarettes
  a screwdriver

>trade cigarettes to marko
Marko examines the ciggaretes and nods. "Alright, this'll do. Here's the hammer from the warehouse. What do you even need it for?"

>i
You are carrying:
  a hammer
  a flashlight
  a milk
  an eggs
  a paper clip
  a magazine
  a screwdriver

>e
Hallway
A long, dimly lit corridor with flickering fluorescent lights.

north - cafeteria, east - gym, west - yard, south - your cell 

Dimitri is suspiciously lurking in front of your cell. He is onto something

You can also see a cell door here.

* * *

>s
Cell
Your home for the past two years. Cold concrete walls surround you, with a rusty sink in the corner and a narrow bed.

north - hallway

An old stained sink with rusty pipes. Behind it, the wall looks suspiciously weak.

You can also see a cell door, a bed and a weak wall here.

>break weak wall with hammer
You swing the hammer hard against the weakened wall. With a deafening crack, the concrete collapses, revealing a jagged hole leading into the janitor's room!

>examine bed
A mattress on which you spent countless nights. It is very old, so try shaking it, maybe something will fall out.

* * *

>shake bed
A paper clip just fell out of the bed and had been added to your inventory

>s
Janitor Room
A cramped storage space filled with cleaning supplies, mops, and buckets. A vent cover is mounted on the wall. There's a janitor uniform hanging on a hook. You can see the hole in the wall that leads back to your cell.

north - cell, south - ventilation 

The keys that you need to escape are in this chest

A vent that leads into the ventilation. It is carefully screwed with 4 screws. You will need a screwdriver to unscrew them

You can also see a hole and a janitor uniform here.

>open crate
You can't see any such thing.

>open crate with paper clip
You can't see any such thing.

>open chest
It seems to be locked.

>open chest with paper clip
That doesn't seem to fit the lock.

>take janitor uniform
Taken.

>lossen screws on vent
That's not a verb I recognise.

>s
(first opening the entry vent)
It seems to be locked.

* * *

>take cigarettes
Taken.

>n
Hallway
A long, dimly lit corridor with flickering fluorescent lights. 

north - cafeteria, 
 east - gym, 
 west - yard, 
 south - your cell

Dimitri is suspiciously lurking in front of your cell. He is onto something

You can also see a cell door here.

>n
Cafeteria
A large room filled with metal tables and benches. The smell of institutional food lingers in the air. A serving counter sits against the far wall.

north - infirmary, 
 south - hallway

Viktor is a new guy that had never been to prison. He doesn't really know about rules of the pod yet

You can also see a protein powder, an eggs and a milk here.

* * *

>trade ring to dimitri
Dimitri grins. "Okay, this should do it. I dont know anything from now on. Good luck with your escape"

>i
You are carrying:
  a cigarettes
  a screwdriver

>w
Yard
An outdoor recreation area surrounded by high concrete walls topped with barbed wire. Guard towers loom in the corners. 

east - hallway

Marko, the inmate who works in the maintenance. He mows the lawn, prunes trees, fixes stuff when they break

>trade ckga
You can't see any such thing.

I beg your pardon?

>trade cigarettes to marko
Marko examines the ciggaretes and nods. "Alright, this'll do. Here's the hammer from the warehouse. What do you even need it for?"

>i
You are carrying:
  a hammer
  a screwdriver

>r
That's not a verb I recognise.

>e
Hallway
A long, dimly lit corridor with flickering fluorescent lights. 

north - cafeteria, 
 east - gym, 
 west - yard, 
 south - your cell

Dimitri is suspiciously lurking in front of your cell. He is onto something

You can also see a cell door here.

>n
Cafeteria
A large room filled with metal tables and benches. The smell of institutional food lingers in the air. A serving counter sits against the far wall.

north - infirmary, 
 south - hallway

Viktor is a new guy that had never been to prison. He doesn't really know about rules of the pod yet

You can also see a protein powder, an eggs and a milk here.

* * *

>take protein powder
Taken.

>d
You can't go that way.

>s
Hallway
A long, dimly lit corridor with flickering fluorescent lights. 

north - cafeteria, 
 east - gym, 
 west - yard, 
 south - your cell

Dimitri is suspiciously lurking in front of your cell. He is onto something

You can also see a cell door here.

>e
Gym
Weight equipment and exercise machines fill this space. Prisoners come here to pass the time and stay strong.

west - hallway

Tony is doing pull-ups, his massive frame barely fitting in the space.

>trade protein powder to tony
Tony's eyes light up. "Perfect! Here, take this flashlight. I stole it from one inmate here."

* * *

>s
Cell
Your home for the past two years. Cold concrete walls surround you, with a rusty sink in the corner and a narrow bed.

north - hallway

An old stained sink with rusty pipes. Behind it, the wall looks suspiciously weak.

You can also see a cell door, a bed, a weak wall and a magazine here.

>shake bed
A paper clip just fell out of the bed and had been added to your inventory

>break weak wall with hammer
You swing the hammer hard against the weakened wall. With a deafening crack, the concrete collapses, revealing a jagged hole leading into the janitor's room!

>s
Janitor Room
A cramped storage space filled with cleaning supplies, mops, and buckets. A vent cover is mounted on the wall. There's a janitor uniform hanging on a hook. You can see the hole in the wall that leads back to your cell.

north - cell, 
 south - ventilation

The keys that you need to escape are in this chest

A vent that leads into the ventilation. It is carefully screwed with 4 screws. You will need a screwdriver to unscrew them

You can also see a hole and a janitor uniform here.

>take janitor uniform
Taken.

>unscrew the vent
(the vent cover)
Nothing obvious happens.

>lossen the vent cover
That's not a verb I recognise.

>loosen the vent cover
You carefully unscrew the four screws holding the vent cover in place. It comes free with a metallic clank. The dark ventilation shaft beckons.

Go south to enter the ventilation shaft.

>i screw
I only understood you as far as wanting to take inventory.

>examine screwd
You can't see any such thing.

>examine screwdriver
A flathead screwdriver, useful for loosening screws. You can try loosening the screws with command: loosen screws on "something"

>s
Darkness
It is pitch dark, and you can't see a thing.

* * *

>s
It's too dark to continue south. You can't see where you're going! Try turning on the flashlight

>examine flashlight
It is pitch dark, and you can't see a thing.

>n
Janitor Room
A cramped storage space filled with cleaning supplies, mops, and buckets. A vent cover is mounted on the wall. There's a janitor uniform hanging on a hook. You can see the hole in the wall that leads back to your cell.

north - cell, 
 south - ventilation

The keys that you need to escape are in this chest

You can also see an entry vent and a hole here.

>examine flashlight
A small flashlight. You can turn it on with command: turn on flashlight. You can turn it off with command: turn off flashlight

The flashlight is currently switched off.

>s
Darkness
It is pitch dark, and you can't see a thing.

>turn on flashlight
You turn on your flashlight, and the beam reveals an exit that leads to garage. Go south to get to garage

* * *

>wear janitor uniform
You put on the janitor uniform.

>s
Garage
A space that stores lawnmovers, tree cutters and everything needed to keep the prison yard clean. This room is very close to the exit. As a matter of fact, the doors, your way out, are to the south. You can climb back into the vent.

north - vent

You can see an exit vent and an exit door here.

>n
Darkness
It is pitch dark, and you can't see a thing.

>turn on flashlight
That's already on.

>s
Garage
A space that stores lawnmovers, tree cutters and everything needed to keep the prison yard clean. This room is very close to the exit. As a matter of fact, the doors, your way out, are to the south. You can climb back into the vent.

north - vent

You can see an exit vent and an exit door here.

* * *

>n
Darkness
It is pitch dark, and you can't see a thing.

>n
Janitor Room
A cramped storage space filled with cleaning supplies, mops, and buckets. A vent cover is mounted on the wall. There's a janitor uniform hanging on a hook. You can see the hole in the wall that leads back to your cell.

north - cell, 
 south - ventilation

The keys that you need to escape are in this chest

You can also see an entry vent and a hole here.

>s
Darkness
It is pitch dark, and you can't see a thing.

>s
Garage
A space that stores lawnmovers, tree cutters and everything needed to keep the prison yard clean. This room is very close to the exit. As a matter of fact, the doors, your way out, are to the south. You can climb back into the vent.

north - vent

You can see an exit vent and an exit door here.

* * *

>n
Janitor Room
A cramped storage space filled with cleaning supplies, mops, and buckets. A vent cover is mounted on the wall. There's a janitor uniform hanging on a hook. You can see the hole in the wall that leads back to your cell.

north - cell, 
 south - ventilation

The keys that you need to escape are in this chest

You can also see an entry vent and a hole here.

>examine paper clip
A paper clip that you pick a lock with. You can pick a lock with this command: pick "something" with paper clip or open "something" with paper clip

>pick chest with shoe
You can't see any such thing.

>pick chest with paper clip
Good job! You picked the lock on the chest. It opens, revealing the keys. Take them and continue your escape plan.

* * *

>take keys
Taken.

>d
You can't go that way.

>s
Darkness
It is pitch dark, and you can't see a thing.

* * *

>s
Garage
A space that stores lawnmovers, tree cutters and everything needed to keep the prison yard clean. This room is very close to the exit. As a matter of fact, the doors, your way out, are to the south. You can climb back into the vent.

north - vent

You can see an exit vent and an exit door here.

>open exit door with keys
You unlock the exit door.

* * *

>take cigarettes
Taken.

>shake bed
A paper clip just fell out of the bed and had been added to your inventory

>n
Hallway
A long, dimly lit corridor with flickering fluorescent lights.

north - cafeteria, east - gym, west - yard, south - your cell 

Dimitri is suspiciously lurking in front of your cell. He is onto something

You can also see a cell door here.

>n
Cafeteria
A large room filled with metal tables and benches. The smell of institutional food lingers in the air. A serving counter sits against the far wall.

north - infirmary, south - hallway

Viktor is a new guy that had never been to prison. He doesn't really know about rules of the pod yet

You can also see a protein powder, an eggs and a milk here.

* * *

>take protein powder
Taken.

>steal ring from viktor
You successfully steal the ring from Viktor. Get out of here before he realizes!

>n
Infirmary
A small medical facility with white walls and the sharp smell of antiseptic. Medical supplies are locked away in cabinets.

south - cafeteria 

Old Pete sweeps the floor slowly, his janitor uniform worn and faded.

>s
Cafeteria
A large room filled with metal tables and benches. The smell of institutional food lingers in the air. A serving counter sits against the far wall.

north - infirmary, south - hallway

Viktor is a new guy that had never been to prison. He doesn't really know about rules of the pod yet

You can also see an eggs and a milk here.

>s
Hallway
A long, dimly lit corridor with flickering fluorescent lights.

north - cafeteria, east - gym, west - yard, south - your cell 

Dimitri is suspiciously lurking in front of your cell. He is onto something

You can also see a cell door here.

>e
Gym
Weight equipment and exercise machines fill this space. Prisoners come here to pass the time and stay strong.

west - hallway 

Tony is doing pull-ups, his massive frame barely fitting in the space.

>trade protein powder to Tony
Tony's eyes light up. "Perfect! Here, take this flashlight. I stole it from one inmate here."

>i
You are carrying:
  a flashlight
  a ring
  a paper clip
  a cigarettes

>w
Hallway
A long, dimly lit corridor with flickering fluorescent lights.

north - cafeteria, east - gym, west - yard, south - your cell 

Dimitri is suspiciously lurking in front of your cell. He is onto something

You can also see a cell door here.

* * *

>w
Yard
An outdoor recreation area surrounded by high concrete walls topped with barbed wire. Guard towers loom in the corners.

east - hallway 

Marko, the inmate who works in the maintenance. He mows the lawn, prunes trees, fixes stuff when they break

>trade cigarettes to marko
Marko examines the ciggaretes and nods. "Alright, this'll do. Here's the hammer from the warehouse. What do you even need it for?"

* * *

>e
Hallway
A long, dimly lit corridor with flickering fluorescent lights.

north - cafeteria, east - gym, west - yard, south - your cell 

Dimitri is suspiciously lurking in front of your cell. He is onto something

You can also see a cell door here.

>s
Cell
Your home for the past two years. Cold concrete walls surround you, with a rusty sink in the corner and a narrow bed.

north - hallway

An old stained sink with rusty pipes. Behind it, the wall looks suspiciously weak.

You can also see a cell door, a bed, a weak wall, a screwdriver and a magazine here.

>inspect weak wall
That's not a verb I recognise.

* * *

>examine weak wall
A section of wall behind the sink that you've been secretly weakening for months. With the right tool, you could break through.

>break weak wall
Violence isn't the answer to this one.

>break weak wall with hammer
You swing the hammer hard against the weakened wall. With a deafening crack, the concrete collapses, revealing a jagged hole leading into the janitor's room!

>s
Dimitri blocks your way. "Not so fast! You think I'm letting you escape without that ring? Bring me Viktor's ring first, or I'm calling the guards."

>talk to dimitri
You can't see any such thing.

>n
Hallway
A long, dimly lit corridor with flickering fluorescent lights.

north - cafeteria, east - gym, west - yard, south - your cell 

Dimitri is suspiciously lurking in front of your cell. He is onto something

You can also see a cell door here.

>trade ring to dimitri
Dimitri grins. "Okay, this should do it. I dont know anything from now on. Good luck with your escape"

>s
Cell
Your home for the past two years. Cold concrete walls surround you, with a rusty sink in the corner and a narrow bed.

north - hallway

An old stained sink with rusty pipes. Behind it, the wall looks suspiciously weak.

You can also see a cell door, a hole, a bed, a screwdriver and a magazine here.

>s
Janitor Room
A cramped storage space filled with cleaning supplies, mops, and buckets. A vent cover is mounted on the wall. There's a janitor uniform hanging on a hook. You can see the hole in the wall that leads back to your cell.

north - cell, south - ventilation 

The keys that you need to escape are in this chest

A vent that leads into the ventilation. It is carefully screwed with 4 screws. You will need a screwdriver to unscrew them

You can also see a hole and a janitor uniform here.

>s
You can't go that way.

* * *

>w
You can't go that way.

>i
You are carrying:
  a hammer
  a flashlight
  a paper clip

>n
Cell
Your home for the past two years. Cold concrete walls surround you, with a rusty sink in the corner and a narrow bed.

north - hallway

An old stained sink with rusty pipes. Behind it, the wall looks suspiciously weak.

You can also see a hole, a cell door, a bed, a screwdriver and a magazine here.

>n
Hallway
A long, dimly lit corridor with flickering fluorescent lights.

north - cafeteria, east - gym, west - yard, south - your cell 

Dimitri is suspiciously lurking in front of your cell. He is onto something

You can also see a cell door here.

>n
Cafeteria
A large room filled with metal tables and benches. The smell of institutional food lingers in the air. A serving counter sits against the far wall.

north - infirmary, south - hallway

Viktor is a new guy that had never been to prison. He doesn't really know about rules of the pod yet

You can also see an eggs and a milk here.

>s
Hallway
A long, dimly lit corridor with flickering fluorescent lights.

north - cafeteria, east - gym, west - yard, south - your cell 

Dimitri is suspiciously lurking in front of your cell. He is onto something

You can also see a cell door here.

>s
Cell
Your home for the past two years. Cold concrete walls surround you, with a rusty sink in the corner and a narrow bed.

north - hallway

An old stained sink with rusty pipes. Behind it, the wall looks suspiciously weak.

You can also see a cell door, a hole, a bed, a screwdriver and a magazine here.

>take screwdriver
Taken.

>s
Janitor Room
A cramped storage space filled with cleaning supplies, mops, and buckets. A vent cover is mounted on the wall. There's a janitor uniform hanging on a hook. You can see the hole in the wall that leads back to your cell.

north - cell, south - ventilation 

The keys that you need to escape are in this chest

A vent that leads into the ventilation. It is carefully screwed with 4 screws. You will need a screwdriver to unscrew them

You can also see a hole and a janitor uniform here.

>loosen the screws on vent
I didn't understand that sentence.

>lossen screws on vent
That's not a verb I recognise.

>loosen screws on vent
(the vent cover)
You carefully unscrew the four screws holding the vent cover in place. It comes free with a metallic clank. The dark ventilation shaft beckons.

Go south to enter the ventilation shaft.

>s
Darkness
It is pitch dark, and you can't see a thing.

* * *

>s
It's too dark to continue south. You can't see where you're going! Try turning on the flashlight

>n
Janitor Room
A cramped storage space filled with cleaning supplies, mops, and buckets. A vent cover is mounted on the wall. There's a janitor uniform hanging on a hook. You can see the hole in the wall that leads back to your cell.

north - cell, south - ventilation 

The keys that you need to escape are in this chest

You can also see an entry vent, a hole and a janitor uniform here.

>s
Darkness
It is pitch dark, and you can't see a thing.

>turn on flashlighht
You turn on your flashlight, and the beam reveals a cover vent in front of you. You should try unscrewing the screws and seeing where it leads.

>s
It's too dark to continue south. You can't see where you're going! Try turning on the flashlight

* * *

>take cigarettes
Taken.

>take screwdriver
Taken.

>shake bed
A paper clip just fell out of the bed and had been added to your inventory

* * *

>n
Cafeteria
A large room filled with metal tables and benches. The smell of institutional food lingers in the air. A serving counter sits against the far wall.

north - infirmary, south - hallway

Viktor is a new guy that had never been to prison. He doesn't really know about rules of the pod yet

You can also see a protein powder, an eggs and a milk here.

>steal ring from viktor
You successfully steal the ring from Viktor. Get out of here before he realizes!

* * *

>e
Gym
Weight equipment and exercise machines fill this space. Prisoners come here to pass the time and stay strong.

west - hallway 

Tony is doing pull-ups, his massive frame barely fitting in the space.

>i
You are carrying:
  a ring
  a paper clip
  a screwdriver
  a cigarettes

>w
Hallway
A long, dimly lit corridor with flickering fluorescent lights.

north - cafeteria, east - gym, west - yard, south - your cell 

Dimitri is suspiciously lurking in front of your cell. He is onto something

You can also see a cell door here.

>n
Cafeteria
A large room filled with metal tables and benches. The smell of institutional food lingers in the air. A serving counter sits against the far wall.

north - infirmary, south - hallway

Viktor is a new guy that had never been to prison. He doesn't really know about rules of the pod yet

You can also see a protein powder, an eggs and a milk here.

* * *

>take protein powder
Taken.

>s
Hallway
A long, dimly lit corridor with flickering fluorescent lights.

north - cafeteria, east - gym, west - yard, south - your cell 

Dimitri is suspiciously lurking in front of your cell. He is onto something

You can also see a cell door here.

* * *

>e
Gym
Weight equipment and exercise machines fill this space. Prisoners come here to pass the time and stay strong.

west - hallway 

Tony is doing pull-ups, his massive frame barely fitting in the space.

>trade protein powder to tony
Tony's eyes light up. "Perfect! Here, take this flashlight. I stole it from one inmate here."

>w
Hallway
A long, dimly lit corridor with flickering fluorescent lights.

north - cafeteria, east - gym, west - yard, south - your cell 

Dimitri is suspiciously lurking in front of your cell. He is onto something

You can also see a cell door here.

* * *

>w
Yard
An outdoor recreation area surrounded by high concrete walls topped with barbed wire. Guard towers loom in the corners.

east - hallway 

Marko, the inmate who works in the maintenance. He mows the lawn, prunes trees, fixes stuff when they break

>trade cigarettees to marko
Marko examines the ciggaretes and nods. "Alright, this'll do. Here's the hammer from the warehouse. What do you even need it for?"

>y
That was a rhetorical question.

>e
Hallway
A long, dimly lit corridor with flickering fluorescent lights.

north - cafeteria, east - gym, west - yard, south - your cell 

Dimitri is suspiciously lurking in front of your cell. He is onto something

You can also see a cell door here.

>s
Cell
Your home for the past two years. Cold concrete walls surround you, with a rusty sink in the corner and a narrow bed.

north - hallway

An old stained sink with rusty pipes. Behind it, the wall looks suspiciously weak.

You can also see a cell door, a bed, a weak wall and a magazine here.

>break weak wall with hammer
You swing the hammer hard against the weakened wall. With a deafening crack, the concrete collapses, revealing a jagged hole leading into the janitor's room!

* * *

>s
Dimitri blocks your way. "Not so fast! You think I'm letting you escape without that ring? Bring me Viktor's ring first, or I'm calling the guards."

>n
Hallway
A long, dimly lit corridor with flickering fluorescent lights.

north - cafeteria, east - gym, west - yard, south - your cell 

Dimitri is suspiciously lurking in front of your cell. He is onto something

You can also see a cell door here.

>trade ring to viktor
You can't see any such thing.

>trade ring to dimitri
Dimitri grins. "Okay, this should do it. I dont know anything from now on. Good luck with your escape"

>s
Cell
Your home for the past two years. Cold concrete walls surround you, with a rusty sink in the corner and a narrow bed.

north - hallway

An old stained sink with rusty pipes. Behind it, the wall looks suspiciously weak.

You can also see a cell door, a hole, a bed and a magazine here.

>s
Janitor Room
A cramped storage space filled with cleaning supplies, mops, and buckets. A vent cover is mounted on the wall. There's a janitor uniform hanging on a hook. You can see the hole in the wall that leads back to your cell.

north - cell, south - ventilation 

The keys that you need to escape are in this chest

A vent that leads into the ventilation. It is carefully screwed with 4 screws. You will need a screwdriver to unscrew them

You can also see a hole and a janitor uniform here.

>take janitor uniform
Taken.

>take keys
You can't see any such thing.

>open chest with paper clip
That doesn't seem to fit the lock.

>loosen the screws on the vent
I didn't understand that sentence.

>loosen screws on the vent
(the vent cover)
You carefully unscrew the four screws holding the vent cover in place. It comes free with a metallic clank. The dark ventilation shaft beckons.

Go south to enter the ventilation shaft.

>s
Darkness
It is pitch dark, and you can't see a thing.

* * *

>s
It's too dark to continue south. You can't see where you're going! Try turning on the flashlight

>i
You are carrying:
  a janitor uniform
  a hammer
  a flashlight
  a paper clip
  a screwdriver

>turn on flashlight
You turn on your flashlight, and the beam reveals an exit that leads to garage. Go south to get to garage

* * *

>s
You have to wear a janitor uniform before you get into garage so you don't get caught

>wear janitor
You put on the janitor uniform.

>s
Garage
A space that stores lawnmovers, tree cutters and everything needed to keep the prison yard clean. This room is very close to the exit. As a matter of fact, the doors, your way out, are to the south. You can climb back into the vent.

north - vent 

You can see a slide and an exit door here.

>open exit door
It seems to be locked.

>open exit door with keys
You can't see any such thing.

I beg your pardon?

>n
Darkness
It is pitch dark, and you can't see a thing.

* * *

>turn on flashlight
That's already on.

>n
Janitor Room
A cramped storage space filled with cleaning supplies, mops, and buckets. A vent cover is mounted on the wall. There's a janitor uniform hanging on a hook. You can see the hole in the wall that leads back to your cell.

north - cell, south - ventilation 

The keys that you need to escape are in this chest

You can also see an entry vent and a hole here.

* * *

>take cigarettes
Taken.

>n
Hallway
A long, dimly lit corridor with flickering fluorescent lights.

north - cafeteria, east - gym, west - yard, south - your cell 

Dimitri is suspiciously lurking in front of your cell. He is onto something

You can also see a cell door here.

>w
Yard
An outdoor recreation area surrounded by high concrete walls topped with barbed wire. Guard towers loom in the corners.

east - hallway 

Marko, the inmate who works in the maintenance. He mows the lawn, prunes trees, fixes stuff when they break

>take protein powder
You can't see any such thing.

>e
Hallway
A long, dimly lit corridor with flickering fluorescent lights.

north - cafeteria, east - gym, west - yard, south - your cell 

Dimitri is suspiciously lurking in front of your cell. He is onto something

You can also see a cell door here.

>w
Yard
An outdoor recreation area surrounded by high concrete walls topped with barbed wire. Guard towers loom in the corners.

east - hallway 

Marko, the inmate who works in the maintenance. He mows the lawn, prunes trees, fixes stuff when they break

>trade cigarettes to Marko
Marko examines the ciggaretes and nods. "Alright, this'll do. Here's the hammer from the warehouse. What do you even need it for?"

>e
Hallway
A long, dimly lit corridor with flickering fluorescent lights.

north - cafeteria, east - gym, west - yard, south - your cell 

Dimitri is suspiciously lurking in front of your cell. He is onto something

You can also see a cell door here.

>n
Cafeteria
A large room filled with metal tables and benches. The smell of institutional food lingers in the air. A serving counter sits against the far wall.

north - infirmary, south - hallway

Viktor is a new guy that had never been to prison. He doesn't really know about rules of the pod yet

You can also see a protein powder, an eggs and a milk here.

* * *

>steal ring from viktor
You successfully steal the ring from Viktor. Get out of here before he realizes!

>talk to viktor
Viktor says, "Do you think I am fitting in in this prison? I am the new fish, how they like to say it. I will trade you playing cards for magazines"

>i
You are carrying:
  a ring
  a protein powder
  a hammer

>s
Hallway
A long, dimly lit corridor with flickering fluorescent lights.

north - cafeteria, east - gym, west - yard, south - your cell 

Dimitri is suspiciously lurking in front of your cell. He is onto something

You can also see a cell door here.

* * *

>trade ring to dimitri
Dimitri grins. "Okay, this should do it. I dont know anything from now on. Good luck with your escape"

>s
Cell
Your home for the past two years. Cold concrete walls surround you, with a rusty sink in the corner and a narrow bed.

north - hallway

An old stained sink with rusty pipes. Behind it, the wall looks suspiciously weak.

You can also see a cell door, a bed, a weak wall, a screwdriver and a magazine here.

>break wall with hammer
You swing the hammer hard against the weakened wall. With a deafening crack, the concrete collapses, revealing a jagged hole leading into the janitor's room!

>n
Hallway
A long, dimly lit corridor with flickering fluorescent lights.

north - cafeteria, east - gym, west - yard, south - your cell 

Dimitri is suspiciously lurking in front of your cell. He is onto something

You can also see a cell door here.

>s
Cell
Your home for the past two years. Cold concrete walls surround you, with a rusty sink in the corner and a narrow bed.

north - hallway

An old stained sink with rusty pipes. Behind it, the wall looks suspiciously weak.

You can also see a cell door, a hole, a bed, a screwdriver and a magazine here.

* * *

>s
Janitor Room
A cramped storage space filled with cleaning supplies, mops, and buckets. A vent cover is mounted on the wall. There's a janitor uniform hanging on a hook. You can see the hole in the wall that leads back to your cell.

north - cell, south - ventilation 

The keys that you need to escape are in this chest

A vent that leads into the ventilation. It is carefully screwed with 4 screws. You will need a screwdriver to unscrew them

You can also see a hole and a janitor uniform here.

>n
Cell
Your home for the past two years. Cold concrete walls surround you, with a rusty sink in the corner and a narrow bed.

north - hallway

An old stained sink with rusty pipes. Behind it, the wall looks suspiciously weak.

You can also see a hole, a cell door, a bed, a screwdriver and a magazine here.

>take screwdriver
Taken.

* * *

>s
Janitor Room
A cramped storage space filled with cleaning supplies, mops, and buckets. A vent cover is mounted on the wall. There's a janitor uniform hanging on a hook. You can see the hole in the wall that leads back to your cell.

north - cell, south - ventilation 

The keys that you need to escape are in this chest

A vent that leads into the ventilation. It is carefully screwed with 4 screws. You will need a screwdriver to unscrew them

You can also see a hole and a janitor uniform here.

>open chest with paper clip
Good job! You picked the lock on the chest. It opens, revealing the keys. Take them and continue your escape plan.

>unscrew the vent
(the vent cover)
Nothing obvious happens.

>loosen screws on vent
(the vent cover)
You carefully unscrew the four screws holding the vent cover in place. It comes free with a metallic clank. The dark ventilation shaft beckons.

Go south to enter the ventilation shaft.

* * *

>s
Darkness
It is pitch dark, and you can't see a thing.

>turn on flashlight
You can't see any such thing.

>i
You are carrying:
  a paper clip
  a screwdriver
  a protein powder
  a hammer

>s
It's too dark to continue south. You can't see where you're going! Try turning on the flashlight

* * *

>n
Janitor Room
A cramped storage space filled with cleaning supplies, mops, and buckets. A vent cover is mounted on the wall. There's a janitor uniform hanging on a hook. You can see the hole in the wall that leads back to your cell.

north - cell, south - ventilation 

The keys that you need to escape are in this chest

You can also see an entry vent, a hole and a janitor uniform here.

>n
Cell
Your home for the past two years. Cold concrete walls surround you, with a rusty sink in the corner and a narrow bed.

north - hallway

An old stained sink with rusty pipes. Behind it, the wall looks suspiciously weak.

You can also see a hole, a cell door, a bed and a magazine here.

>n
Hallway
A long, dimly lit corridor with flickering fluorescent lights.

north - cafeteria, east - gym, west - yard, south - your cell 

Dimitri is suspiciously lurking in front of your cell. He is onto something

You can also see a cell door here.

>e
Gym
Weight equipment and exercise machines fill this space. Prisoners come here to pass the time and stay strong.

west - hallway 

Tony is doing pull-ups, his massive frame barely fitting in the space.

* * *

>w
Hallway
A long, dimly lit corridor with flickering fluorescent lights.

north - cafeteria, east - gym, west - yard, south - your cell 

Dimitri is suspiciously lurking in front of your cell. He is onto something

You can also see a cell door here.

>s
Cell
Your home for the past two years. Cold concrete walls surround you, with a rusty sink in the corner and a narrow bed.

north - hallway

An old stained sink with rusty pipes. Behind it, the wall looks suspiciously weak.

You can also see a cell door, a hole, a bed and a magazine here.

>s
Janitor Room
A cramped storage space filled with cleaning supplies, mops, and buckets. A vent cover is mounted on the wall. There's a janitor uniform hanging on a hook. You can see the hole in the wall that leads back to your cell.

north - cell, south - ventilation 

The keys that you need to escape are in this chest

You can also see a hole, an entry vent and a janitor uniform here.

>s
Darkness
It is pitch dark, and you can't see a thing.

* * *

>s
You have to wear a janitor uniform before you get into garage so you don't get caught

>i
You are carrying:
  a flashlight
  a paper clip
  a screwdriver
  a hammer

>n
Janitor Room
A cramped storage space filled with cleaning supplies, mops, and buckets. A vent cover is mounted on the wall. There's a janitor uniform hanging on a hook. You can see the hole in the wall that leads back to your cell.

north - cell, south - ventilation 

The keys that you need to escape are in this chest

You can also see an entry vent, a hole and a janitor uniform here.

>pick keys
What do you want to pick the keys with?

>take keys
Taken.

>s
Darkness
It is pitch dark, and you can't see a thing.

>s
You have to wear a janitor uniform before you get into garage so you don't get caught

>wear janitor uniform
You can't see any such thing.

>n
Janitor Room
A cramped storage space filled with cleaning supplies, mops, and buckets. A vent cover is mounted on the wall. There's a janitor uniform hanging on a hook. You can see the hole in the wall that leads back to your cell.

north - cell, south - ventilation 

The keys that you need to escape are in this chest

You can also see an entry vent, a hole and a janitor uniform here.

>take janitor uniform
Taken.

>weare janitor
That's not a verb I recognise.

>wear janitor
You put on the janitor uniform.

>s
Darkness
It is pitch dark, and you can't see a thing.

>s
Garage
A space that stores lawnmovers, tree cutters and everything needed to keep the prison yard clean. This room is very close to the exit. As a matter of fact, the doors, your way out, are to the south. You can climb back into the vent.

north - vent 

You can see a slide and an exit door here.

>open door with keys
You unlock the exit door.

>s
(first opening the exit door)

    *** You unlock the door, step through, and escape. You win! ***

Would you like to RESTART, RESTORE a saved game, QUIT or UNDO the last command?